Jurisdiction,Overseas,Locally acquired - contact of confirmed case,Locally acquired - unknown contact,Locally acquired - interstate travel,Under investigation,Total cases,Total deaths,Date
NT,196,11,0,5,0,212,0,2021-10-06
Australia,8427,52839,43967,224,10345,115802,1357,2021-10-06
ACT,95,908,126,30,3,1162,8,2021-10-06
NSW,3659,22215,39895,107,0,65876,439,2021-10-06
QLD,1490,479,47,32,0,2048,7,2021-10-06
SA,684,178,9,36,0,907,4,2021-10-06
VIC,1224,28814,3871,0,10342,44251,877,2021-10-06
WA,994,93,14,9,0,1110,9,2021-10-06
TAS,85,141,5,5,0,236,13,2021-10-06
Australia,8435,55200,44390,225,11793,120043,1389,2021-10-07
NSW,3658,22952,40307,107,0,67024,457,2021-10-07
NT,197,11,0,5,0,213,0,2021-10-07
QLD,1498,479,47,32,0,2056,7,2021-10-07
SA,684,178,9,36,0,907,4,2021-10-07
TAS,85,141,5,5,0,236,13,2021-10-07
VIC,1224,30404,3871,0,11767,47266,890,2021-10-07
WA,994,93,14,9,0,1110,9,2021-10-07
ACT,95,942,137,31,26,1231,9,2021-10-07
WA,994,93,14,9,0,1110,9,2021-10-08
NT,197,11,0,5,0,213,0,2021-10-08
QLD,1498,479,47,32,0,2056,7,2021-10-08
SA,685,178,9,36,0,908,4,2021-10-08
TAS,85,141,5,5,0,236,13,2021-10-08
VIC,1224,30506,3873,0,13486,49089,895,2021-10-08
Australia,8438,55584,44799,225,13506,122552,1405,2021-10-08
ACT,95,980,145,31,20,1271,9,2021-10-08
NSW,3660,23196,40706,107,0,67669,468,2021-10-08
NSW,3661,23479,40999,107,0,68246,479,2021-10-09
SA,685,178,9,37,0,909,4,2021-10-09
TAS,85,141,5,5,0,236,13,2021-10-09
VIC,1224,31973,3871,0,13944,51012,900,2021-10-09
WA,994,93,14,9,0,1110,9,2021-10-09
ACT,95,1004,147,31,19,1296,9,2021-10-09
Australia,8443,57358,45092,226,13963,125082,1421,2021-10-09
NT,198,11,0,5,0,214,0,2021-10-09
QLD,1501,479,47,32,0,2059,7,2021-10-09
WA,994,93,14,9,0,1110,9,2021-10-10
NT,198,11,5,0,0,214,0,2021-10-10
QLD,1503,479,47,32,1,2062,7,2021-10-10
SA,685,178,9,38,0,910,4,2021-10-10
TAS,85,141,5,5,0,236,13,2021-10-10
VIC,1225,32023,3871,0,15765,52884,905,2021-10-10
NSW,3662,23749,41192,109,0,68712,485,2021-10-10
ACT,95,1024,150,32,25,1326,9,2021-10-10
Australia,8447,57698,45293,225,15791,127454,1432,2021-10-10
Australia,8453,58998,45356,233,16530,129570,1448,2021-10-11
VIC,1225,32865,3872,0,16508,54470,913,2021-10-11
TAS,85,141,5,5,0,236,13,2021-10-11
SA,686,178,9,40,0,913,4,2021-10-11
WA,994,93,14,9,0,1110,9,2021-10-11
NT,199,11,0,5,0,215,0,2021-10-11
NSW,3664,24179,41253,109,0,69205,493,2021-10-11
ACT,95,1052,156,33,22,1358,9,2021-10-11
QLD,1505,479,47,32,0,2063,7,2021-10-11
Australia,8457,60794,45426,235,16468,131380,1461,2021-10-12
WA,995,93,14,9,0,1111,9,2021-10-12
VIC,1225,34306,3905,0,16462,55898,921,2021-10-12
TAS,85,141,5,5,0,236,13,2021-10-12
SA,686,178,9,41,0,914,4,2021-10-12
ACT,95,1076,176,33,6,1386,9,2021-10-12
NSW,3663,24510,41270,109,0,69552,498,2021-10-12
QLD,1509,479,47,32,0,2067,7,2021-10-12
NT,199,11,0,6,0,216,0,2021-10-12
QLD,1509,479,47,32,0,2067,7,2021-10-13
SA,686,178,9,41,0,914,4,2021-10-13
TAS,85,141,5,5,0,236,13,2021-10-13
Australia,8457,60794,45426,235,16468,131380,1461,2021-10-13
NT,199,11,0,6,0,216,0,2021-10-13
ACT,95,1076,176,33,6,1386,9,2021-10-13
WA,995,93,14,9,0,1111,9,2021-10-13
VIC,1225,34306,3905,0,16462,55898,921,2021-10-13
NSW,3663,24510,41270,109,0,69552,498,2021-10-13
NT,204,11,0,7,0,222,0,2021-10-14
WA,995,93,14,9,0,1111,9,2021-10-14
QLD,1509,479,47,32,0,2067,7,2021-10-14
TAS,85,141,5,6,0,237,13,2021-10-14
SA,686,179,9,40,0,914,4,2021-10-14
Australia,8467,63205,45608,236,18619,136135,1496,2021-10-14
ACT,95,1151,194,33,10,1483,10,2021-10-14
NSW,3666,25208,41408,109,0,70391,508,2021-10-14
VIC,1227,35943,3931,0,18609,59710,945,2021-10-14
WA,995,93,14,9,0,1111,9,2021-10-15
VIC,1227,35976,3943,0,20723,61869,951,2021-10-15
SA,686,179,9,40,0,914,4,2021-10-15
QLD,1510,479,47,33,0,2069,7,2021-10-15
Australia,8468,63454,45825,240,20734,138721,1506,2021-10-15
ACT,95,1178,199,35,11,1518,10,2021-10-15
TAS,85,141,5,6,0,237,13,2021-10-15
NSW,3666,25397,41608,110,0,70781,512,2021-10-15
NT,204,11,0,7,0,222,0,2021-10-15
ACT,95,1193,199,35,16,1538,11,2021-10-16
WA,996,93,14,9,0,1112,9,2021-10-16
NSW,3667,25569,41753,110,0,71099,514,2021-10-16
NT,204,11,0,10,0,225,0,2021-10-16
QLD,1512,479,47,33,0,2071,7,2021-10-16
SA,687,179,9,40,0,915,4,2021-10-16
TAS,85,141,5,6,0,237,13,2021-10-16
VIC,1227,38267,3948,0,20394,63836,957,2021-10-16
Australia,8473,65932,45975,243,20410,141033,1515,2021-10-16
VIC,1227,39092,3953,0,21333,65605,963,2021-10-17
TAS,85,141,5,6,0,237,13,2021-10-17
SA,687,179,9,40,0,915,4,2021-10-17
QLD,1512,479,47,33,0,2071,7,2021-10-17
NSW,3667,25747,41875,110,0,71399,524,2021-10-17
ACT,95,1222,211,35,8,1571,11,2021-10-17
NT,204,11,0,10,0,225,0,2021-10-17
WA,996,93,14,9,0,1112,9,2021-10-17
Australia,8473,66964,46114,243,21341,143135,1531,2021-10-17
VIC,1227,39995,3958,0,22277,67457,970,2021-10-18
WA,996,93,14,9,0,1112,9,2021-10-18
Australia,8474,68083,46181,243,22282,145263,1543,2021-10-18
NSW,3668,25951,41929,110,0,71658,529,2021-10-18
ACT,95,1234,219,35,5,1588,11,2021-10-18
QLD,1512,479,47,33,0,2071,7,2021-10-18
SA,687,179,9,40,0,915,4,2021-10-18
TAS,85,141,5,6,0,237,13,2021-10-18
NT,204,11,0,10,0,225,0,2021-10-18
Australia,8475,69391,46280,243,22886,147275,1558,2021-10-19
NSW,3668,26147,41998,110,0,71923,533,2021-10-19
NT,204,11,0,10,0,225,0,2021-10-19
QLD,1512,479,47,33,0,2071,7,2021-10-19
SA,688,179,9,40,0,916,4,2021-10-19
TAS,85,141,5,6,0,237,13,2021-10-19
VIC,1227,41083,3983,0,22886,69179,981,2021-10-19
WA,996,93,14,9,0,1112,9,2021-10-19
ACT,95,1258,224,35,0,1612,11,2021-10-19
Australia,8477,70416,46378,243,23884,149398,1577,2021-10-20
TAS,85,141,5,6,0,237,13,2021-10-20
SA,688,179,9,40,0,916,4,2021-10-20
QLD,1513,479,47,33,0,2072,7,2021-10-20
NT,204,11,0,10,0,225,0,2021-10-20
NSW,3668,26356,42068,110,0,72202,540,2021-10-20
ACT,95,1274,232,35,0,1636,11,2021-10-20
VIC,1228,41883,4003,0,23884,70998,993,2021-10-20
WA,996,93,14,9,0,1112,9,2021-10-20
WA,996,93,14,9,0,1112,9,2021-10-21
VIC,1231,42988,4007,0,24925,73151,1005,2021-10-21
TAS,85,141,5,6,0,237,13,2021-10-21
SA,689,179,9,40,0,917,4,2021-10-21
QLD,1517,479,48,33,0,2077,7,2021-10-21
NT,204,11,0,10,0,225,0,2021-10-21
NSW,3670,26605,42175,110,0,72560,541,2021-10-21
Australia,8487,71788,46499,244,24925,151943,1590,2021-10-21
ACT,95,1292,241,36,0,1664,11,2021-10-21
ACT,95,1292,241,36,0,1664,11,2021-10-22
NSW,3670,26605,42175,110,0,72560,541,2021-10-22
NT,204,11,0,10,0,225,0,2021-10-22
QLD,1517,479,48,33,0,2077,7,2021-10-22
SA,689,179,9,40,0,917,4,2021-10-22
TAS,85,141,5,6,0,237,13,2021-10-22
VIC,1231,42988,4007,0,24925,73151,1005,2021-10-22
WA,996,93,14,9,0,1112,9,2021-10-22
Australia,8487,71788,46499,244,24925,151943,1590,2021-10-22
Australia,8498,72416,46706,245,28507,156372,1622,2021-10-23
ACT,95,1321,249,36,0,1701,11,2021-10-23
NSW,3672,27070,42360,110,0,73212,548,2021-10-23
NT,204,11,0,10,0,225,0,2021-10-23
VIC,1235,43122,4022,0,28507,76886,1030,2021-10-23
SA,689,179,9,40,0,917,4,2021-10-23
TAS,85,141,5,6,0,237,13,2021-10-23
WA,996,93,14,9,0,1112,9,2021-10-23
QLD,1522,479,47,34,0,2082,7,2021-10-23
VIC,1234,45598,4022,0,27909,78763,1041,2021-10-24
WA,996,93,14,9,0,1112,9,2021-10-24
TAS,85,141,5,6,0,237,13,2021-10-24
ACT,95,1330,247,38,0,1710,11,2021-10-24
QLD,1522,479,47,34,0,2082,7,2021-10-24
NT,204,11,0,10,0,225,0,2021-10-24
NSW,3671,27502,42217,110,0,73500,552,2021-10-24
Australia,8497,75333,46561,247,27909,158547,1637,2021-10-24
SA,690,179,9,40,0,918,4,2021-10-24
WA,996,93,14,9,0,1112,9,2021-10-25
VIC,1234,45655,4022,0,29241,80152,1048,2021-10-25
TAS,85,141,5,6,0,237,13,2021-10-25
SA,690,179,9,40,0,918,4,2021-10-25
QLD,1522,479,47,34,0,2082,7,2021-10-25
NT,204,11,0,10,0,225,0,2021-10-25
NSW,3671,27973,42031,110,0,73785,556,2021-10-25
Australia,8497,75869,46377,246,29241,160230,1648,2021-10-25
ACT,95,1338,249,37,0,1719,11,2021-10-25
Australia,8501,77551,45964,247,29753,162016,1653,2021-10-26
NT,204,11,0,10,0,225,0,2021-10-26
WA,996,93,14,9,0,1112,9,2021-10-26
VIC,1234,46628,4036,0,29753,81651,1052,2021-10-26
TAS,85,141,5,6,0,237,13,2021-10-26
SA,690,179,9,40,0,918,4,2021-10-26
QLD,1523,480,47,35,0,2085,7,2021-10-26
ACT,96,1348,250,37,0,1731,11,2021-10-26
NSW,3673,28671,41603,110,0,74057,557,2021-10-26
NSW,3674,29909,40659,110,0,74352,560,2021-10-27
NT,204,11,0,10,0,225,0,2021-10-27
QLD,1524,480,47,35,0,2086,7,2021-10-27
TAS,85,141,5,6,0,237,13,2021-10-27
VIC,1233,48120,4045,0,29700,83098,1065,2021-10-27
WA,996,93,14,9,0,1112,9,2021-10-27
SA,690,179,9,40,0,918,4,2021-10-27
ACT,96,1356,251,38,0,1741,11,2021-10-27
Australia,8502,80289,45030,248,29700,163769,1669,2021-10-27
VIC,1233,49063,4047,0,30599,84942,1090,2021-10-28
WA,996,93,14,9,0,1112,9,2021-10-28
TAS,85,141,5,6,0,237,13,2021-10-28
SA,690,179,9,40,0,918,4,2021-10-28
QLD,1525,480,47,35,0,2087,7,2021-10-28
NT,204,11,0,10,0,225,0,2021-10-28
ACT,96,1364,251,38,0,1749,11,2021-10-28
Australia,8503,81756,44798,248,30599,165904,1696,2021-10-28
NSW,3674,30425,40425,110,0,74634,562,2021-10-28
SA,690,179,9,40,0,918,4,2021-10-29
WA,996,93,14,9,0,1112,9,2021-10-29
Australia,8507,83166,44461,248,31408,167790,1708,2021-10-29
VIC,1234,49860,4061,0,31408,86563,1100,2021-10-29
QLD,1527,480,47,35,0,2089,7,2021-10-29
NT,204,11,0,10,0,225,0,2021-10-29
NSW,3675,31032,40070,110,0,74887,564,2021-10-29
TAS,85,141,5,6,0,237,13,2021-10-29
ACT,96,1370,255,38,0,1759,11,2021-10-29
VIC,1234,50829,4074,0,31757,87894,1111,2021-10-30
WA,996,93,14,9,0,1112,9,2021-10-30
SA,690,179,9,40,0,918,4,2021-10-30
QLD,1527,480,47,35,0,2089,7,2021-10-30
NT,204,11,0,10,0,225,0,2021-10-30
NSW,3676,31431,39895,110,0,75112,567,2021-10-30
ACT,96,1375,255,42,0,1768,11,2021-10-30
TAS,85,141,5,6,0,237,13,2021-10-30
Australia,8508,84539,44299,252,31757,169355,1722,2021-10-30
Australia,8509,85428,44028,252,32241,170458,1734,2021-10-31
VIC,1234,51257,4092,0,32241,88824,1122,2021-10-31
ACT,96,1382,255,42,0,1775,11,2021-10-31
SA,690,179,9,40,0,918,4,2021-10-31
NT,204,11,0,10,0,225,0,2021-10-31
QLD,1527,480,47,35,0,2089,7,2021-10-31
TAS,85,141,5,6,0,237,13,2021-10-31
NSW,3677,31885,39606,110,0,75278,568,2021-10-31
WA,996,93,14,9,0,1112,9,2021-10-31
QLD,1528,480,47,35,0,2090,7,2021-11-01
ACT,96,1386,256,42,0,1780,13,2021-11-01
NSW,3676,32490,39130,111,0,75407,572,2021-11-01
NT,204,11,0,10,0,225,0,2021-11-01
SA,690,179,9,40,0,918,4,2021-11-01
TAS,85,141,5,6,0,237,13,2021-11-01
VIC,1234,51317,4096,0,33614,90261,1125,2021-11-01
WA,996,93,14,9,0,1112,9,2021-11-01
Australia,8509,86097,43557,253,33614,172030,1743,2021-11-01
VIC,1234,52609,4110,0,33264,91217,1134,2021-11-02
WA,996,93,14,9,0,1112,9,2021-11-02
TAS,85,141,5,6,0,237,13,2021-11-02
ACT,96,1394,256,42,0,1788,13,2021-11-02
QLD,1528,480,47,35,0,2090,7,2021-11-02
NT,204,11,0,10,0,225,0,2021-11-02
NSW,3676,33091,38698,113,0,75578,576,2021-11-02
Australia,8509,87998,43139,255,33264,173165,1756,2021-11-02
SA,690,179,9,40,0,918,4,2021-11-02
WA,996,93,14,9,0,1112,9,2021-11-03
VIC,1234,53225,4112,0,33555,92126,1142,2021-11-03
TAS,85,141,5,6,0,237,13,2021-11-03
SA,690,179,9,40,0,918,4,2021-11-03
QLD,1527,480,47,35,0,2089,7,2021-11-03
NT,204,11,0,10,0,225,0,2021-11-03
NSW,3676,33636,38339,114,0,75765,580,2021-11-03
ACT,96,1407,258,42,0,1803,13,2021-11-03
Australia,8508,89172,42784,256,33555,174275,1768,2021-11-03
Australia,8510,90602,42369,259,34073,175813,1781,2021-11-04
WA,996,93,14,9,0,1112,9,2021-11-04
VIC,1234,53907,4127,0,34071,93339,1151,2021-11-04
TAS,85,141,5,6,0,237,13,2021-11-04
SA,690,179,9,40,0,918,4,2021-11-04
QLD,1527,481,47,36,1,2092,7,2021-11-04
NT,205,11,0,10,0,226,0,2021-11-04
NSW,3677,34370,37910,116,0,76073,584,2021-11-04
ACT,96,1420,257,42,1,1816,13,2021-11-04
VIC,1234,54528,4133,0,34774,94669,1161,2021-11-05
Australia,8513,91838,42006,260,34776,177393,1795,2021-11-05
ACT,97,1424,258,42,1,1822,14,2021-11-05
NSW,3677,34981,37539,117,0,76314,587,2021-11-05
WA,996,93,14,9,0,1112,9,2021-11-05
TAS,85,141,5,6,0,237,13,2021-11-05
QLD,1529,481,47,36,1,2094,7,2021-11-05
SA,690,179,9,40,0,918,4,2021-11-05
NT,205,11,1,10,0,227,0,2021-11-05
ACT,97,1436,264,43,0,1840,14,2021-11-06
NSW,3678,35541,37243,118,0,76580,590,2021-11-06
NT,205,12,1,10,1,229,0,2021-11-06
QLD,1529,482,47,37,0,2095,7,2021-11-06
SA,690,179,9,40,0,918,4,2021-11-06
TAS,85,141,5,6,0,237,13,2021-11-06
VIC,1234,55147,4148,0,35388,95917,1168,2021-11-06
WA,996,93,14,9,0,1112,9,2021-11-06
Australia,8514,93031,41731,263,35389,178928,1805,2021-11-06
Australia,8517,94154,41518,266,35852,180307,1815,2021-11-07
ACT,97,1448,265,43,0,1853,14,2021-11-07
NSW,3679,35999,37019,120,0,76817,591,2021-11-07
SA,690,179,9,40,0,918,4,2021-11-07
NT,205,12,2,10,0,229,0,2021-11-07
QLD,1531,482,47,38,0,2098,7,2021-11-07
WA,996,93,14,9,0,1112,9,2021-11-07
TAS,85,141,5,6,0,237,13,2021-11-07
VIC,1234,55800,4157,0,35852,97043,1177,2021-11-07
SA,690,179,9,40,0,918,4,2021-11-08
Australia,8518,95383,41194,267,36216,181578,1827,2021-11-08
ACT,97,1460,265,44,0,1866,14,2021-11-08
WA,996,93,14,9,0,1112,9,2021-11-08
VIC,1234,56499,4181,0,36216,98130,1182,2021-11-08
TAS,85,141,5,6,0,237,13,2021-11-08
QLD,1531,482,47,38,0,2098,7,2021-11-08
NT,205,12,2,10,0,229,0,2021-11-08
NSW,3680,36517,36671,120,0,76988,598,2021-11-08
WA,996,93,14,9,0,1112,9,2021-11-09
VIC,1234,57056,4205,0,36688,99183,1192,2021-11-09
Australia,8522,96560,40829,271,36688,182870,1841,2021-11-09
ACT,98,1476,264,46,0,1884,14,2021-11-09
NSW,3682,37119,36285,121,0,77207,602,2021-11-09
NT,205,14,0,11,0,230,0,2021-11-09
SA,690,179,9,40,0,918,4,2021-11-09
TAS,85,141,5,6,0,237,13,2021-11-09
QLD,1532,482,47,38,0,2099,7,2021-11-09
WA,996,93,14,9,0,1112,9,2021-11-10
ACT,98,1483,265,47,0,1893,14,2021-11-10
NSW,3685,37692,35918,122,0,77417,605,2021-11-10
NT,205,14,0,12,0,231,0,2021-11-10
QLD,1532,483,48,39,0,2102,7,2021-11-10
SA,690,179,9,40,0,918,4,2021-11-10
Australia,8525,97601,40493,275,37178,184072,1858,2021-11-10
VIC,1234,57516,4234,0,37178,100162,1206,2021-11-10
TAS,85,141,5,6,0,237,13,2021-11-10
VIC,1234,57573,4283,0,38361,101451,1209,2021-11-11
TAS,85,141,5,6,0,237,13,2021-11-11
SA,690,179,9,40,0,918,4,2021-11-11
QLD,1533,484,49,39,0,2105,7,2021-11-11
NT,205,14,0,12,0,231,0,2021-11-11
NSW,3688,38180,35680,123,0,77671,606,2021-11-11
Australia,8529,98165,40293,279,38361,185627,1862,2021-11-11
WA,996,93,14,9,0,1112,9,2021-11-11
ACT,98,1501,253,50,0,1902,14,2021-11-11
WA,996,93,14,9,0,1112,9,2021-11-12
VIC,1234,58579,4317,0,38422,102552,1218,2021-11-12
TAS,85,141,5,6,0,237,13,2021-11-12
SA,691,179,9,40,0,919,4,2021-11-12
QLD,1535,486,49,39,0,2109,7,2021-11-12
NT,205,14,0,12,0,231,0,2021-11-12
NSW,3688,38815,35324,124,0,77951,608,2021-11-12
Australia,8532,99817,39976,281,38422,187028,1873,2021-11-12
ACT,98,1510,258,51,0,1917,14,2021-11-12
VIC,1234,59073,4334,0,39119,103760,1222,2021-11-13
WA,996,93,14,9,0,1112,9,2021-11-13
Australia,8535,100995,39563,282,39119,188494,1877,2021-11-13
ACT,98,1516,263,51,0,1928,14,2021-11-13
SA,692,179,9,40,0,920,4,2021-11-13
NT,205,14,0,12,0,231,0,2021-11-13
QLD,1532,486,49,39,0,2106,7,2021-11-13
TAS,85,141,5,6,0,237,13,2021-11-13
NSW,3693,39493,34889,125,0,78200,608,2021-11-13
VIC,1235,59124,4341,0,39946,104646,1226,2021-11-14
ACT,98,1525,269,51,0,1943,14,2021-11-14
WA,996,93,14,9,0,1112,9,2021-11-14
TAS,85,141,5,6,0,237,13,2021-11-14
Australia,8536,101607,39214,285,39946,189588,1882,2021-11-14
QLD,1532,486,49,39,0,2106,7,2021-11-14
SA,692,179,9,40,0,920,4,2021-11-14
NSW,3693,40045,34527,128,0,78393,609,2021-11-14
NT,205,14,0,12,0,231,0,2021-11-14
NSW,3694,40634,34101,127,0,78556,610,2021-11-15
ACT,98,1532,272,51,0,1953,14,2021-11-15
Australia,8541,103036,38801,285,39941,190604,1888,2021-11-15
NT,205,14,0,12,0,231,0,2021-11-15
QLD,1535,486,49,39,0,2109,7,2021-11-15
SA,692,179,9,40,0,920,4,2021-11-15
TAS,85,141,5,7,0,238,13,2021-11-15
VIC,1235,59957,4351,0,39941,105484,1231,2021-11-15
WA,997,93,14,9,0,1113,9,2021-11-15
NT,207,17,0,12,0,236,0,2021-11-16
ACT,98,1542,274,51,0,1965,14,2021-11-16
Australia,8549,104059,38399,286,40321,191614,1898,2021-11-16
QLD,1536,486,49,39,0,2110,7,2021-11-16
NSW,3696,41188,33677,127,78,78766,612,2021-11-16
TAS,85,141,5,7,0,238,13,2021-11-16
VIC,1235,60413,4371,0,40243,106262,1239,2021-11-16
WA,1000,93,14,9,0,1116,9,2021-11-16
SA,692,179,9,41,0,921,4,2021-11-16
VIC,1235,61033,4388,0,40589,107245,1248,2021-11-17
TAS,85,141,5,7,0,238,13,2021-11-17
Australia,8553,105279,38033,301,40674,192840,1907,2021-11-17
ACT,98,1550,272,51,0,1971,14,2021-11-17
SA,692,179,9,41,0,921,4,2021-11-17
WA,1000,93,14,9,0,1116,9,2021-11-17
QLD,1537,486,49,38,0,2110,7,2021-11-17
NT,206,27,0,12,0,245,0,2021-11-17
NSW,3700,41770,33296,143,85,78994,612,2021-11-17
SA,692,179,9,41,0,921,4,2021-11-18
VIC,1236,61472,4431,0,41092,108231,1260,2021-11-18
QLD,1538,486,49,38,0,2111,7,2021-11-18
ACT,98,1564,280,54,0,1996,14,2021-11-18
Australia,8557,106304,37721,308,41229,194119,1922,2021-11-18
NT,206,33,0,12,0,251,0,2021-11-18
NSW,3701,42336,32933,147,137,79254,615,2021-11-18
WA,1001,93,14,9,0,1117,9,2021-11-18
TAS,85,141,5,7,0,238,13,2021-11-18
VIC,1235,62048,4469,0,41743,109495,1268,2021-11-19
TAS,85,141,5,7,0,238,13,2021-11-19
SA,693,179,9,41,0,922,4,2021-11-19
QLD,1539,486,49,38,0,2112,7,2021-11-19
NT,206,34,0,12,0,252,0,2021-11-19
NSW,3702,42930,32594,150,92,79468,618,2021-11-19
ACT,98,1577,284,54,0,2013,14,2021-11-19
Australia,8560,107488,37424,311,41835,195618,1933,2021-11-19
WA,1002,93,14,9,0,1118,9,2021-11-19
ACT,98,1589,285,54,0,2026,14,2021-11-20
QLD,1539,486,49,38,0,2112,7,2021-11-20
SA,693,179,9,41,0,922,4,2021-11-20
WA,1003,93,14,9,0,1119,9,2021-11-20
VIC,1235,62589,4502,0,42336,110662,1273,2021-11-20
NSW,3705,43472,32226,160,83,79646,618,2021-11-20
Australia,8564,108584,37090,321,42419,196978,1938,2021-11-20
TAS,85,141,5,7,0,238,13,2021-11-20
NT,206,35,0,12,0,253,0,2021-11-20
VIC,1235,63168,4519,0,43004,111926,1277,2021-11-21
QLD,1539,486,49,38,0,2112,7,2021-11-21
SA,693,179,9,41,0,922,4,2021-11-21
NT,207,43,0,12,2,264,0,2021-11-21
NSW,3706,44008,31853,166,88,79821,618,2021-11-21
ACT,98,1603,287,54,0,2042,14,2021-11-21
Australia,8567,109721,36736,327,43094,198445,1942,2021-11-21
TAS,85,141,5,7,0,238,13,2021-11-21
WA,1004,93,14,9,0,1120,9,2021-11-21
WA,1005,93,14,9,0,1121,9,2021-11-22
TAS,85,141,5,8,0,239,13,2021-11-22
SA,693,179,9,41,0,922,4,2021-11-22
VIC,1235,63761,4554,0,43392,112942,1280,2021-11-22
Australia,8573,110686,36581,332,43479,199651,1948,2021-11-22
ACT,98,1609,290,56,0,2053,14,2021-11-22
NSW,3710,44372,31660,168,87,79997,621,2021-11-22
NT,208,45,0,12,0,265,0,2021-11-22
QLD,1539,486,49,38,0,2112,7,2021-11-22
WA,1005,93,14,9,0,1121,9,2021-11-23
VIC,1235,64246,4581,0,43693,113755,1298,2021-11-23
Australia,8578,111453,36516,335,43772,200654,1968,2021-11-23
TAS,85,141,5,8,0,239,13,2021-11-23
SA,693,179,9,41,0,922,4,2021-11-23
QLD,1540,486,49,38,0,2113,7,2021-11-23
NT,207,50,0,12,0,269,0,2021-11-23
ACT,98,1625,294,55,0,2072,14,2021-11-23
NSW,3715,44633,31564,172,79,80163,623,2021-11-23
VIC,1236,64740,4610,0,44357,114943,1301,2021-11-24
TAS,85,141,5,8,0,239,13,2021-11-24
SA,693,179,9,41,0,922,4,2021-11-24
QLD,1542,486,49,38,0,2115,7,2021-11-24
NT,207,53,0,12,0,272,0,2021-11-24
WA,1005,93,14,9,0,1121,9,2021-11-24
NSW,3719,44798,31580,179,132,80408,625,2021-11-24
ACT,98,1634,295,60,0,2087,14,2021-11-24
Australia,8585,112124,36562,347,44489,202107,1973,2021-11-24
NT,207,62,0,12,0,281,0,2021-11-25
VIC,1236,65287,4638,0,45028,116189,1306,2021-11-25
QLD,1541,486,49,41,0,2117,7,2021-11-25
WA,1006,93,14,9,0,1122,9,2021-11-25
TAS,85,141,5,8,0,239,13,2021-11-25
SA,693,179,9,45,0,926,4,2021-11-25
Australia,8594,112939,36597,361,45159,203650,1978,2021-11-25
ACT,98,1637,297,63,0,2095,14,2021-11-25
NSW,3728,45054,31585,183,131,80681,625,2021-11-25
NSW,3731,45518,31370,186,133,80938,625,2021-11-26
ACT,98,1644,299,62,0,2103,14,2021-11-26
Australia,8597,113570,36402,364,46338,205271,1985,2021-11-26
VIC,1236,65447,4656,0,46205,117544,1313,2021-11-26
SA,694,179,9,46,0,928,4,2021-11-26
TAS,85,141,5,8,0,239,13,2021-11-26
NT,207,62,0,12,0,281,0,2021-11-26
QLD,1540,486,49,41,0,2116,7,2021-11-26
WA,1006,93,14,9,0,1122,9,2021-11-26
QLD,1540,487,49,41,0,2117,7,2021-11-27
Australia,8601,114179,36186,373,47409,206748,1990,2021-11-27
ACT,98,1651,298,63,0,2110,14,2021-11-27
NSW,3735,46003,31129,191,112,81170,625,2021-11-27
NT,207,63,0,12,0,282,0,2021-11-27
WA,1006,93,14,9,0,1122,9,2021-11-27
VIC,1236,65562,4682,0,47297,118777,1318,2021-11-27
TAS,85,141,5,8,0,239,13,2021-11-27
SA,694,179,9,49,0,931,4,2021-11-27
Australia,8610,115903,35967,381,47121,207982,1994,2021-11-28
ACT,98,1656,298,65,0,2117,14,2021-11-28
NSW,3739,46432,30890,196,98,81355,625,2021-11-28
WA,1006,92,14,9,0,1121,9,2021-11-28
VIC,1237,66853,4702,0,47023,119815,1322,2021-11-28
NT,209,63,0,12,0,284,0,2021-11-28
QLD,1542,487,49,42,0,2120,7,2021-11-28
SA,694,179,9,49,0,931,4,2021-11-28
TAS,85,141,5,8,0,239,13,2021-11-28
SA,695,179,9,49,0,932,4,2021-11-29
TAS,85,141,5,8,0,239,13,2021-11-29
VIC,1237,66943,4731,0,47903,120814,1325,2021-11-29
NT,209,67,0,12,0,288,0,2021-11-29
NSW,3749,46950,30535,201,64,81499,625,2021-11-29
ACT,98,1664,299,63,0,2124,14,2021-11-29
Australia,8626,116523,35642,384,47967,209142,1997,2021-11-29
QLD,1547,487,49,42,0,2125,7,2021-11-29
WA,1006,92,14,9,0,1121,9,2021-11-29
WA,1006,92,14,9,0,1121,9,2021-11-30
ACT,98,1670,299,63,0,2130,14,2021-11-30
Australia,8638,118711,34465,389,48036,210239,2006,2021-11-30
NSW,3761,48324,29304,204,81,81674,628,2021-11-30
VIC,1237,67750,4785,0,47955,121727,1331,2021-11-30
NT,209,68,0,12,0,289,0,2021-11-30
QLD,1547,487,49,44,0,2127,7,2021-11-30
TAS,85,141,5,8,0,239,13,2021-11-30
SA,695,179,9,49,0,932,4,2021-11-30
WA,1006,92,14,9,0,1121,9,2021-12-01
SA,696,179,10,49,0,934,4,2021-12-01
NSW,3772,48958,28864,206,116,81916,628,2021-12-01
NT,209,68,0,12,0,289,0,2021-12-01
TAS,85,141,5,8,1,240,13,2021-12-01
ACT,98,1672,301,63,0,2134,14,2021-12-01
Australia,8652,119811,34061,392,48738,211654,2011,2021-12-01
QLD,1549,487,49,45,0,2130,7,2021-12-01
VIC,1237,68214,4818,0,48621,122890,1336,2021-12-01
QLD,1549,487,50,47,0,2133,7,2021-12-02
WA,1006,92,14,9,0,1121,9,2021-12-02
NT,211,69,0,12,0,292,0,2021-12-02
Australia,8672,120782,33937,406,49563,213360,2021,2021-12-02
ACT,98,1676,305,63,0,2142,14,2021-12-02
NSW,3779,49375,28692,216,118,82180,628,2021-12-02
VIC,1247,68745,4862,0,49445,124299,1346,2021-12-02
TAS,86,141,5,8,0,240,13,2021-12-02
SA,696,197,9,51,0,953,4,2021-12-02
NSW,3788,49882,28435,221,188,82514,628,2021-12-03
NT,211,70,0,12,0,293,0,2021-12-03
QLD,1549,487,50,53,0,2139,7,2021-12-03
SA,696,197,9,53,2,957,4,2021-12-03
ACT,98,1679,304,65,0,2146,14,2021-12-03
VIC,1252,69382,4868,0,49972,125474,1357,2021-12-03
WA,1007,92,14,9,0,1122,9,2021-12-03
Australia,8687,121930,33685,421,50162,214885,2032,2021-12-03
TAS,86,141,5,8,0,240,13,2021-12-03
Australia,8703,122771,33660,435,51007,216576,2042,2021-12-04
ACT,98,1679,307,69,0,2153,14,2021-12-04
NSW,3793,50256,28367,230,191,82837,629,2021-12-04
QLD,1552,491,50,51,1,2145,7,2021-12-04
SA,696,200,9,55,2,962,4,2021-12-04
TAS,86,141,5,8,0,240,13,2021-12-04
VIC,1260,69842,4908,0,50813,126823,1365,2021-12-04
WA,1007,92,14,9,0,1122,9,2021-12-04
NT,211,70,0,13,0,294,1,2021-12-04
TAS,86,141,5,8,0,240,13,2021-12-05
WA,1007,92,14,9,0,1122,9,2021-12-05
QLD,1553,493,49,56,1,2152,7,2021-12-05
NT,211,70,0,13,0,294,1,2021-12-05
NSW,3807,50711,28231,233,136,83118,630,2021-12-05
ACT,99,1684,304,69,0,2156,14,2021-12-05
Australia,8720,123672,33540,445,51462,217839,2050,2021-12-05
SA,697,202,9,57,3,968,4,2021-12-05
VIC,1260,70279,4928,0,51322,127789,1372,2021-12-05
QLD,1554,493,49,58,1,2155,7,2021-12-06
NT,211,72,0,13,0,296,1,2021-12-06
ACT,100,1692,303,69,0,2164,14,2021-12-06
SA,698,203,9,59,2,971,4,2021-12-06
TAS,86,141,5,8,0,240,13,2021-12-06
VIC,1260,70787,4990,0,51812,128849,1378,2021-12-06
WA,1007,92,14,9,0,1122,9,2021-12-06
NSW,3815,50893,28233,241,139,83321,630,2021-12-06
Australia,8731,124373,33603,457,51954,219118,2056,2021-12-06
WA,1007,92,14,9,0,1122,9,2021-12-07
VIC,1265,70833,4994,0,52937,130029,1385,2021-12-07
TAS,86,141,5,8,0,240,13,2021-12-07
QLD,1554,494,50,57,0,2155,7,2021-12-07
ACT,101,1692,303,71,0,2167,14,2021-12-07
NSW,3832,51301,27991,250,198,83572,632,2021-12-07
NT,213,72,0,13,0,298,1,2021-12-07
SA,698,205,9,61,2,975,4,2021-12-07
Australia,8756,124830,33366,469,53137,220558,2065,2021-12-07
VIC,1274,71786,4999,0,53266,131325,1390,2021-12-08
NSW,3838,51716,27866,257,290,83967,633,2021-12-08
NT,213,73,0,13,0,299,1,2021-12-08
QLD,1554,495,50,58,0,2157,7,2021-12-08
SA,699,207,10,60,0,976,4,2021-12-08
TAS,86,141,5,8,0,240,13,2021-12-08
Australia,8772,126209,33247,477,53556,222261,2072,2021-12-08
ACT,101,1699,303,72,0,2175,15,2021-12-08
WA,1007,92,14,9,0,1122,9,2021-12-08
WA,1008,92,14,9,0,1123,9,2021-12-09
VIC,1279,72304,5005,0,53954,132542,1399,2021-12-09
TAS,86,141,5,8,0,240,13,2021-12-09
NT,215,76,0,13,0,304,1,2021-12-09
NSW,3849,52064,27894,260,317,84384,634,2021-12-09
ACT,102,1701,304,72,0,2179,15,2021-12-09
Australia,8794,127082,33282,483,54271,223912,2082,2021-12-09
QLD,1554,495,50,58,0,2157,7,2021-12-09
SA,701,209,10,63,0,983,4,2021-12-09
WA,1008,92,14,9,0,1123,9,2021-12-10
VIC,1290,72812,5010,0,54622,133734,1401,2021-12-10
TAS,86,141,5,8,0,240,13,2021-12-10
SA,702,211,11,67,0,991,4,2021-12-10
QLD,1555,497,51,62,0,2165,7,2021-12-10
NT,215,78,0,13,1,307,1,2021-12-10
NSW,3855,52500,27864,266,410,84895,634,2021-12-10
ACT,102,1704,305,74,0,2185,15,2021-12-10
Australia,8813,128035,33260,499,55033,225640,2084,2021-12-10
VIC,1297,73250,5015,0,55349,134911,1414,2021-12-11
Australia,8835,128903,33351,511,55788,227388,2100,2021-12-11
ACT,104,1711,305,76,0,2196,15,2021-12-11
WA,1008,92,14,9,0,1123,9,2021-12-11
NT,215,78,0,13,0,306,1,2021-12-11
NSW,3868,52918,27947,275,439,85447,637,2021-12-11
TAS,86,141,5,8,0,240,13,2021-12-11
SA,702,214,14,68,0,998,4,2021-12-11
QLD,1555,499,51,62,0,2167,7,2021-12-11
WA,1008,92,14,9,0,1123,9,2021-12-12
Australia,8848,129707,33455,512,56408,228930,2104,2021-12-12
ACT,105,1715,303,74,0,2197,15,2021-12-12
NT,216,82,0,13,0,311,1,2021-12-12
QLD,1556,499,51,62,0,2168,7,2021-12-12
SA,702,220,14,69,3,1008,4,2021-12-12
TAS,86,141,5,8,0,240,13,2021-12-12
VIC,1296,73716,5017,0,55930,135959,1416,2021-12-12
NSW,3879,53242,28051,277,475,85924,639,2021-12-12
WA,1009,92,14,9,0,1124,9,2021-12-13
VIC,1295,74150,5044,0,56738,137227,1418,2021-12-13
TAS,86,141,5,8,0,240,13,2021-12-13
SA,704,226,15,75,0,1020,4,2021-12-13
QLD,1557,498,51,70,0,2176,7,2021-12-13
NT,216,84,0,13,0,313,1,2021-12-13
ACT,106,1715,302,77,0,2200,15,2021-12-13
NSW,3889,53844,27981,278,461,86453,639,2021-12-13
Australia,8862,130750,33412,530,57199,230753,2106,2021-12-13
TAS,86,141,5,8,0,240,13,2021-12-14
VIC,1316,74208,5064,0,57821,138409,1424,2021-12-14
WA,1010,92,14,9,0,1125,9,2021-12-14
SA,704,232,16,74,5,1031,4,2021-12-14
QLD,1558,498,51,73,0,2180,7,2021-12-14
NT,216,99,0,13,0,328,1,2021-12-14
NSW,3902,54354,27973,283,736,87248,640,2021-12-14
Australia,8900,131341,33425,537,58562,232765,2113,2021-12-14
ACT,108,1717,302,77,0,2204,15,2021-12-14
VIC,1332,75088,5078,0,58306,139804,1427,2021-12-15
TAS,86,141,5,8,0,240,13,2021-12-15
ACT,109,1718,302,82,0,2211,15,2021-12-15
NSW,3921,54848,28100,290,1436,88595,641,2021-12-15
NT,223,106,0,13,0,342,1,2021-12-15
QLD,1559,498,52,78,1,2188,7,2021-12-15
SA,705,250,20,77,5,1057,4,2021-12-15
WA,1010,92,14,9,0,1125,9,2021-12-15
Australia,8945,132741,33571,557,59748,235562,2117,2021-12-15
NSW,3934,55720,28328,301,2050,90333,641,2021-12-16
NT,223,106,0,14,0,343,1,2021-12-16
QLD,1562,500,53,90,4,2209,7,2021-12-16
SA,706,260,24,85,6,1081,4,2021-12-16
TAS,86,141,5,9,0,241,13,2021-12-16
WA,1010,92,14,9,0,1125,9,2021-12-16
Australia,8974,134289,33822,598,61286,238969,2126,2021-12-16
VIC,1343,75751,5095,0,59226,141415,1436,2021-12-16
ACT,110,1719,303,90,0,2222,15,2021-12-16
ACT,110,1726,304,102,0,2242,15,2021-12-17
NSW,3943,56930,28636,314,2709,92532,642,2021-12-17
NT,223,109,0,16,0,348,1,2021-12-17
QLD,1567,506,59,93,2,2227,7,2021-12-17
SA,708,302,32,86,15,1143,4,2021-12-17
TAS,86,141,5,11,0,243,13,2021-12-17
VIC,1358,76339,5098,0,60112,142907,1443,2021-12-17
WA,1010,92,14,9,0,1125,9,2021-12-17
Australia,9005,136145,34148,631,62838,242767,2134,2021-12-17
SA,709,330,38,89,50,1216,4,2021-12-18
WA,1010,92,14,9,0,1125,9,2021-12-18
VIC,1364,76833,5100,0,61045,144342,1450,2021-12-18
TAS,86,141,5,12,0,244,13,2021-12-18
QLD,1569,515,60,98,16,2258,7,2021-12-18
NT,223,113,0,16,0,352,1,2021-12-18
NSW,3962,58176,28982,323,3557,95000,643,2021-12-18
ACT,110,1736,305,109,0,2260,15,2021-12-18
Australia,9033,137936,34504,656,64668,246797,2142,2021-12-18
WA,1010,92,14,9,0,1125,9,2021-12-19
VIC,1369,77363,5102,0,61736,145570,1454,2021-12-19
TAS,87,141,5,12,2,247,13,2021-12-19
SA,709,382,36,95,74,1296,4,2021-12-19
Australia,9073,139820,34770,680,66385,250728,2146,2021-12-19
NT,225,116,0,16,0,357,1,2021-12-19
NSW,3991,59445,29251,333,4538,97558,643,2021-12-19
ACT,112,1756,298,108,4,2278,15,2021-12-19
QLD,1570,525,64,107,31,2297,7,2021-12-19
TAS,88,141,5,17,0,251,13,2021-12-20
SA,709,432,37,98,124,1400,4,2021-12-20
QLD,1573,546,62,115,60,2356,7,2021-12-20
NT,225,122,0,16,0,363,1,2021-12-20
NSW,4016,60463,29522,340,5699,100040,643,2021-12-20
ACT,112,1761,298,114,6,2291,15,2021-12-20
Australia,9107,141418,35050,709,68401,254685,2146,2021-12-20
VIC,1374,77861,5112,0,62512,146859,1454,2021-12-20
WA,1010,92,14,9,0,1125,9,2021-12-20
Australia,9178,143259,35414,744,70612,259207,2154,2021-12-21
ACT,113,1767,299,120,8,2307,15,2021-12-21
NSW,4046,61628,29860,347,7192,103073,645,2021-12-21
NT,225,133,0,18,0,376,1,2021-12-21
TAS,88,142,5,18,1,254,13,2021-12-21
SA,712,482,54,111,195,1554,4,2021-12-21
VIC,1404,78454,5120,0,63111,148089,1460,2021-12-21
WA,1011,92,14,9,0,1126,9,2021-12-21
QLD,1579,561,62,121,105,2428,7,2021-12-21
NSW,4046,61628,29860,347,7192,103073,645,2021-12-22
ACT,113,1767,299,120,8,2307,15,2021-12-22
NT,225,133,0,18,0,376,1,2021-12-22
QLD,1579,561,62,121,105,2428,7,2021-12-22
SA,712,482,54,111,195,1554,4,2021-12-22
TAS,88,142,5,18,1,254,13,2021-12-22
VIC,1404,78454,5120,0,63111,148089,1460,2021-12-22
WA,1011,92,14,9,0,1126,9,2021-12-22
Australia,9178,143259,35414,744,70612,259207,2154,2021-12-22
SA,714,818,103,153,1129,2917,4,2021-12-24
ACT,118,1886,311,181,56,2552,15,2021-12-24
NSW,4135,65236,31599,362,16742,118074,649,2021-12-24
NT,226,144,1,28,0,399,1,2021-12-24
QLD,1582,646,113,143,1079,3563,7,2021-12-24
TAS,89,147,6,37,41,320,13,2021-12-24
VIC,1527,80159,5170,0,66775,153631,1484,2021-12-24
WA,1014,93,14,11,1,1133,9,2021-12-24
Australia,9405,149129,37317,915,85823,282589,2182,2021-12-24
Australia,9405,149129,37317,915,85823,282589,2182,2021-12-25
ACT,118,1886,311,181,56,2552,15,2021-12-25
NSW,4135,65236,31599,362,16742,118074,649,2021-12-25
NT,226,144,1,28,0,399,1,2021-12-25
TAS,89,147,6,37,41,320,13,2021-12-25
SA,714,818,103,153,1129,2917,4,2021-12-25
VIC,1527,80159,5170,0,66775,153631,1484,2021-12-25
WA,1014,93,14,11,1,1133,9,2021-12-25
QLD,1582,646,113,143,1079,3563,7,2021-12-25
ACT,118,1908,320,193,217,2756,15,2021-12-26
Australia,9450,151572,38585,1122,101231,301960,2190,2021-12-26
NSW,4149,66758,32432,386,26976,130701,649,2021-12-26
NT,227,162,0,43,0,432,1,2021-12-26
SA,720,1139,439,241,1785,4324,4,2021-12-26
TAS,92,150,8,68,86,404,13,2021-12-26
VIC,1542,80597,5179,0,69849,157167,1492,2021-12-26
WA,1018,99,14,12,0,1143,9,2021-12-26
QLD,1584,759,193,179,2318,5033,7,2021-12-26
NT,228,169,1,50,0,448,1,2021-12-27
Australia,9460,153517,39330,1172,108617,312096,2197,2021-12-27
ACT,118,1909,321,194,400,2942,15,2021-12-27
NSW,4155,67598,32931,400,31927,137011,652,2021-12-27
SA,720,1227,613,257,2345,5162,5,2021-12-27
TAS,92,161,15,74,101,443,13,2021-12-27
VIC,1543,81559,5221,0,70824,159147,1495,2021-12-27
WA,1018,101,14,12,0,1145,9,2021-12-27
QLD,1586,793,214,185,3020,5798,7,2021-12-27
SA,720,1691,583,271,2895,6160,5,2021-12-28
TAS,94,175,19,79,120,487,13,2021-12-28
QLD,1586,862,263,201,4049,6961,7,2021-12-28
VIC,1553,82237,5224,0,72831,161845,1499,2021-12-28
ACT,118,1928,329,198,613,3186,15,2021-12-28
Australia,9485,155934,40052,1230,116584,323285,2202,2021-12-28
NSW,4166,68764,33620,416,36076,143042,653,2021-12-28
WA,1020,101,14,13,0,1148,9,2021-12-28
NT,228,176,0,52,0,456,1,2021-12-28
TAS,94,193,24,85,149,545,13,2021-12-29
Australia,9500,158468,40982,1288,131199,341437,2210,2021-12-29
ACT,118,2066,329,198,613,3324,15,2021-12-29
NSW,4172,69919,34318,432,45350,154191,656,2021-12-29
NT,228,185,4,60,0,477,1,2021-12-29
QLD,1588,941,327,221,5455,8532,7,2021-12-29
WA,1020,101,14,13,0,1148,9,2021-12-29
SA,720,1901,726,279,3999,7625,5,2021-12-29
VIC,1560,83162,5240,0,75633,165595,1504,2021-12-29
ACT,118,2319,329,198,600,3564,15,2021-12-30
Australia,9521,161241,42073,1355,148487,362677,2226,2021-12-30
WA,1021,103,14,14,1,1153,9,2021-12-30
VIC,1563,84139,5256,0,79737,170695,1518,2021-12-30
TAS,95,218,33,103,188,637,13,2021-12-30
SA,722,2190,848,289,4944,8993,6,2021-12-30
QLD,1589,1029,385,233,7516,10752,7,2021-12-30
NT,228,197,6,66,13,510,1,2021-12-30
NSW,4185,71046,35202,452,55488,166373,657,2021-12-30
VIC,1563,85409,5258,0,84304,176534,1525,2021-12-31
TAS,95,264,57,145,224,785,13,2021-12-31
SA,723,2216,848,291,7000,11078,6,2021-12-31
QLD,1590,1133,480,252,10408,13863,7,2021-12-31
WA,1025,103,14,15,1,1158,9,2021-12-31
NSW,4188,71985,35926,466,74939,187504,663,2021-12-31
ACT,118,2781,329,198,584,4010,15,2021-12-31
NT,228,224,9,87,24,572,1,2021-12-31
Australia,9530,164115,42921,1454,177484,395504,2239,2021-12-31
WA,1026,105,14,15,1,1161,9,2022-01-01
VIC,1565,86660,5261,0,90415,183901,1534,2022-01-01
SA,723,2312,1332,311,8500,13178,6,2022-01-01
TAS,95,295,80,173,581,1224,13,2022-01-01
NT,228,241,23,115,17,624,1,2022-01-01
NSW,4189,72984,36660,474,95744,210051,668,2022-01-01
ACT,0,4448,0,0,0,4448,15,2022-01-01
Australia,9417,168238,43943,1345,207769,430712,2253,2022-01-01
QLD,1591,1193,573,257,12511,16125,7,2022-01-01
SA,723,2373,1327,317,10733,15473,8,2022-01-02
ACT,0,4919,0,0,0,4919,15,2022-01-02
NSW,4192,73672,37182,485,112776,228307,669,2022-01-02
NT,228,247,25,150,77,727,1,2022-01-02
QLD,1592,1247,600,264,16004,19707,7,2022-01-02
TAS,95,311,97,180,945,1628,13,2022-01-02
Australia,9423,169558,44508,1414,238025,462928,2259,2022-01-02
VIC,1565,86683,5262,0,97489,190999,1537,2022-01-02
WA,1028,106,15,18,1,1168,9,2022-01-02
VIC,1582,89886,5269,0,102791,199528,1540,2022-01-03
WA,1030,107,17,21,1,1176,9,2022-01-03
SA,723,2372,1326,317,13283,18021,8,2022-01-03
Australia,9452,174018,45118,1512,269858,499958,2266,2022-01-03
QLD,1592,1301,619,274,20155,23941,7,2022-01-03
NT,233,266,41,202,63,805,1,2022-01-03
TAS,95,343,111,193,1358,2100,13,2022-01-03
NSW,4197,74420,37735,505,132207,249064,673,2022-01-03
ACT,0,5323,0,0,0,5323,15,2022-01-03
Australia,9473,179422,46261,1643,310854,547653,2271,2022-01-04
WA,1031,107,17,33,2,1190,9,2022-01-04
VIC,1583,92673,5268,0,113966,213490,1542,2022-01-04
TAS,102,371,118,211,2003,2805,13,2022-01-04
SA,726,2999,1686,348,15496,21255,8,2022-01-04
QLD,1594,1419,721,285,25607,29626,7,2022-01-04
NT,237,287,44,245,70,883,1,2022-01-04
NSW,4200,75322,38407,521,153710,272160,676,2022-01-04
ACT,0,6244,0,0,0,6244,15,2022-01-04
WA,1037,110,18,37,4,1206,9,2022-01-05
NSW,4202,76054,38946,534,187437,307173,683,2022-01-05
NT,239,351,81,302,12,985,1,2022-01-05
QLD,1594,1470,815,295,32227,36401,7,2022-01-05
SA,727,4358,1798,372,17490,24745,8,2022-01-05
TAS,103,403,133,222,2810,3671,13,2022-01-05
VIC,1593,95713,5269,0,128344,230919,1553,2022-01-05
ACT,0,7006,0,0,0,7006,15,2022-01-05
Australia,9495,185465,47060,1762,368324,612106,2289,2022-01-05
Australia,9530,191715,47701,1900,433381,684227,2301,2022-01-06
ACT,0,8021,0,0,0,8021,15,2022-01-06
SA,727,4721,1796,372,20197,27813,8,2022-01-06
WA,1039,111,18,45,2,1215,9,2022-01-06
VIC,1605,99733,5272,0,146052,252662,1559,2022-01-06
TAS,103,429,149,238,3503,4422,13,2022-01-06
NSW,4205,76780,39449,546,221153,342133,689,2022-01-06
NT,257,369,113,386,105,1230,1,2022-01-06
QLD,1594,1551,904,313,42369,46731,7,2022-01-06
ACT,0,9429,0,0,0,9429,15,2022-01-07
Australia,9529,238036,8707,2132,503522,761926,2319,2022-01-07
VIC,1606,103874,5285,0,163358,274123,1565,2022-01-07
NSW,4211,117593,0,573,258173,380550,700,2022-01-07
NT,243,134,445,575,108,1505,1,2022-01-07
QLD,1594,1632,998,321,53132,57677,8,2022-01-07
SA,730,4821,1794,373,23795,31513,8,2022-01-07
TAS,103,442,168,241,4954,5908,13,2022-01-07
WA,1042,111,17,49,2,1221,9,2022-01-07
Australia,9569,252531,13814,3244,570675,849833,2345,2022-01-08
ACT,0,10777,0,0,0,10777,15,2022-01-08
NSW,4212,119192,0,612,301577,425593,709,2022-01-08
QLD,1594,1744,1059,327,64059,68783,9,2022-01-08
NT,246,306,538,669,179,1938,1,2022-01-08
TAS,104,459,185,246,5954,6948,13,2022-01-08
VIC,1606,108389,5292,0,183492,298779,1574,2022-01-08
WA,1043,112,16,55,3,1229,9,2022-01-08
SA,764,11552,6724,1335,15411,35786,15,2022-01-08
WA,1043,116,15,56,1,1231,9,2022-01-09
TAS,106,500,213,252,6442,7513,13,2022-01-09
SA,785,15151,8970,1974,13414,40294,16,2022-01-09
VIC,1607,108416,5320,0,206128,321471,1578,2022-01-09
NT,247,437,601,745,208,2238,1,2022-01-09
NSW,4216,120722,0,636,329955,455529,725,2022-01-09
ACT,0,12176,0,0,0,12176,15,2022-01-09
Australia,9598,259316,16289,3993,633696,922892,2367,2022-01-09
QLD,1594,1798,1170,330,77548,82440,10,2022-01-09
ACT,0,13248,0,0,0,13248,15,2022-01-10
NSW,4219,122410,0,666,348436,475731,743,2022-01-10
NT,250,566,628,798,383,2625,1,2022-01-10
QLD,1595,1831,1196,330,83340,88292,10,2022-01-10
SA,798,16759,10071,2202,14483,44313,18,2022-01-10
TAS,106,525,240,256,6771,7898,13,2022-01-10
VIC,1606,119177,5324,0,214017,340124,1580,2022-01-10
WA,1044,119,16,60,0,1239,9,2022-01-10
Australia,9618,274635,17475,4312,667430,973470,2389,2022-01-10
NT,258,581,636,842,697,3014,1,2022-01-11
VIC,1606,123299,5324,0,231002,361231,1593,2022-01-11
TAS,106,531,251,257,7105,8250,13,2022-01-11
SA,811,18027,10965,2394,14993,47190,19,2022-01-11
QLD,1595,1875,1262,331,99596,104659,11,2022-01-11
NSW,4222,124142,0,692,372333,501389,754,2022-01-11
WA,1045,122,16,71,0,1254,9,2022-01-11
ACT,0,15306,0,0,0,15306,16,2022-01-11
Australia,9643,283883,18454,4587,725726,1042293,2416,2022-01-11
Australia,9658,293178,269012,4817,547473,1124138,2465,2022-01-12
ACT,0,16358,0,0,0,16358,16,2022-01-12
NSW,4226,125907,0,723,405169,536025,775,2022-01-12
NT,258,591,649,852,982,3332,1,2022-01-12
QLD,1595,1917,1332,332,117559,122735,11,2022-01-12
SA,821,19366,12110,2575,15958,50830,26,2022-01-12
TAS,106,544,267,261,7804,8982,13,2022-01-12
VIC,1606,128372,254638,0,0,384616,1614,2022-01-12
WA,1046,123,16,74,1,1260,9,2022-01-12
QLD,1595,1985,1432,332,129476,134820,17,2022-01-13
VIC,1606,134549,5337,0,266095,407587,1639,2022-01-13
TAS,106,553,276,263,8029,9227,13,2022-01-13
SA,821,19351,12100,2578,19558,54408,30,2022-01-13
WA,1049,125,16,85,1,1276,9,2022-01-13
NT,257,598,662,868,1441,3826,1,2022-01-13
NSW,4230,127528,0,758,433837,566353,797,2022-01-13
ACT,0,17661,0,0,0,17661,16,2022-01-13
Australia,9664,302350,19823,4884,858437,1195158,2522,2022-01-13
Australia,9679,310419,20873,5079,915743,1261793,2578,2022-01-14
ACT,0,18490,0,0,0,18490,16,2022-01-14
NSW,4233,129014,0,788,456763,590798,826,2022-01-14
NT,258,614,672,879,1787,4210,1,2022-01-14
QLD,1595,2054,1538,337,142731,148255,20,2022-01-14
SA,831,20554,13020,2718,22904,60027,36,2022-01-14
TAS,106,557,289,265,8380,9597,13,2022-01-14
VIC,1606,139009,5338,0,283178,429131,1657,2022-01-14
WA,1050,127,16,92,0,1285,9,2022-01-14
ACT,0,19065,0,0,0,19065,16,2022-01-15
Australia,9710,317857,22167,5266,966985,1321985,2633,2022-01-15
NSW,4234,129655,0,812,483013,617714,846,2022-01-15
NT,260,707,770,906,2143,4786,2,2022-01-15
SA,858,21778,14139,2847,24644,64266,40,2022-01-15
TAS,106,559,292,266,8676,9899,13,2022-01-15
VIC,1606,143859,5338,0,292288,443091,1681,2022-01-15
WA,1051,128,16,98,0,1293,9,2022-01-15
QLD,1595,2106,1612,337,156221,161871,26,2022-01-15
NSW,4234,129932,816,0,503449,638431,866,2022-01-16
WA,1051,130,16,99,1,1297,9,2022-01-16
VIC,1606,152304,5346,0,303232,462488,1689,2022-01-16
TAS,106,561,294,266,8961,10188,13,2022-01-16
SA,880,22922,15232,2934,24650,66618,42,2022-01-16
Australia,9732,328420,24131,4554,1011612,1378449,2668,2022-01-16
ACT,0,19687,0,0,0,19687,18,2022-01-16
QLD,1595,2150,1648,338,168945,174676,29,2022-01-16
NT,260,734,779,917,2374,5064,2,2022-01-16
Australia,9732,328420,24131,4554,1011612,1378449,2668,2022-01-17
SA,880,22922,15232,2934,24650,66618,42,2022-01-17
ACT,0,19687,0,0,0,19687,18,2022-01-17
WA,1051,130,16,99,1,1297,9,2022-01-17
NSW,4234,129932,816,0,503449,638431,866,2022-01-17
NT,260,734,779,917,2374,5064,2,2022-01-17
QLD,1595,2150,1648,338,168945,174676,29,2022-01-17
TAS,106,561,294,266,8961,10188,13,2022-01-17
VIC,1606,152304,5346,0,303232,462488,1689,2022-01-17
Australia,9754,332131,24923,5563,1053130,1425501,2698,2022-01-18
TAS,106,561,295,266,9352,10580,13,2022-01-18
ACT,0,20468,0,0,0,20468,19,2022-01-18
NSW,4234,130047,0,820,520906,656007,883,2022-01-18
NT,259,912,1065,967,1981,5184,2,2022-01-18
QLD,1596,2209,1703,339,179348,185195,36,2022-01-18
SA,901,24438,16474,3064,26276,71153,42,2022-01-18
VIC,1606,153362,5370,0,315267,475605,1694,2022-01-18
WA,1052,134,16,107,0,1309,9,2022-01-18
Australia,8191,184302,22271,5827,1286011,1506602,2841,2022-01-19
NT,260,939,1081,969,2099,5348,2,2022-01-19
NSW,4240,130754,0,828,555531,691353,951,2022-01-19
QLD,1596,2406,1873,339,202925,209139,63,2022-01-19
SA,935,26650,19001,3306,27291,77183,47,2022-01-19
TAS,106,563,300,266,10269,11504,13,2022-01-19
VIC,0,0,0,0,487895,487895,1736,2022-01-19
WA,1054,138,16,119,1,1328,9,2022-01-19
ACT,0,22852,0,0,0,22852,20,2022-01-19
TAS,106,565,303,266,10558,11798,13,2022-01-20
WA,1055,142,16,123,2,1338,9,2022-01-20
VIC,1606,164175,5372,0,327856,499009,1746,2022-01-20
SA,960,27774,20184,3441,28033,80392,58,2022-01-20
ACT,0,23068,0,0,0,23068,20,2022-01-20
NT,258,950,1081,980,2203,5472,2,2022-01-20
NSW,4248,131713,0,852,571891,708704,976,2022-01-20
Australia,9832,351503,29817,6059,1152934,1550145,2896,2022-01-20
QLD,1599,3116,2861,397,212391,220364,72,2022-01-20
Australia,9832,351503,29817,6059,1152934,1550145,2896,2022-01-21
WA,1055,142,16,123,2,1338,9,2022-01-21
VIC,1606,164175,5372,0,327856,499009,1746,2022-01-21
TAS,106,565,303,266,10558,11798,13,2022-01-21
SA,960,27774,20184,3441,28033,80392,58,2022-01-21
QLD,1599,3116,2861,397,212391,220364,72,2022-01-21
NT,258,950,1081,980,2203,5472,2,2022-01-21
NSW,4248,131713,0,852,571891,708704,976,2022-01-21
ACT,0,23068,0,0,0,23068,20,2022-01-21
